terminalName,Street Address,location,Bikes Available,Docks Empty,Total Station Capacity,Time Imported
31204,20th & E St NW,"(38.8963, -77.045)",0,14,14,12:23:20
31205,21st & I St NW,"(38.9008, -77.047)",3,32,35,12:23:20
31215,Georgetown Harbor / 30th St NW,"(38.9022212, -77.059219)",2,16,18,12:23:20
31227,13th St & New York Ave NW,"(38.900283, -77.029822)",7,15,22,12:23:20
31232,7th & F St NW / National Portrait Gallery,"(38.897332, -77.022292)",4,22,26,12:23:20
31233,17th & K St NW / Farragut Square,"(38.902061, -77.038322)",3,32,35,12:23:20
31000,Eads St & 15th St S,"(38.858971, -77.05323)",3,12,15,12:23:20
31001,18th & Eads St.,"(38.85725, -77.05332)",5,6,11,12:23:20
31002,Crystal Dr & 20th St S,"(38.856425, -77.049232)",6,10,16,12:23:20
31003,Crystal Dr & 15th St S,"(38.86017, -77.049593)",2,7,9,12:23:20
31004,Aurora Hills Community Ctr/18th & Hayes St,"(38.857866, -77.05949)",2,9,11,12:23:20
31005,Pentagon City Metro / 12th & S Hayes St,"(38.862303, -77.059936)",0,19,19,12:23:20
31006,S Joyce & Army Navy Dr,"(38.8637, -77.0633)",7,7,14,12:23:20
31007,Crystal City Metro / 18th & Bell St,"(38.85740496261504, -77.05113172531128)",4,14,18,12:23:20
31008,12th & Army Navy Dr,"(38.8629, -77.0528)",0,11,11,12:23:20
31009,Crystal Dr & 27th St S,"(38.848466, -77.051514)",5,5,10,12:23:20
31010,S Glebe & Potomac Ave,"(38.8426, -77.0502)",4,6,10,12:23:20
31011,Crystal Dr & 23rd St S,"(38.8533, -77.0498)",7,9,16,12:23:20
31012,26th & S Clark St,"(38.850688, -77.05152)",6,3,9,12:23:20
31100,19th St & Pennsylvania Ave NW,"(38.9003, -77.0429)",9,4,13,12:23:20
31101,14th & V St NW,"(38.9176, -77.0321)",18,9,27,12:23:20
31102,11th & Kenyon St NW,"(38.929464, -77.027822)",0,26,26,12:23:20
31103,16th & Harvard St NW,"(38.926088, -77.036536)",10,22,32,12:23:20
31104,Adams Mill & Columbia Rd NW,"(38.922925, -77.042581)",7,8,15,12:23:20
31105,14th & Harvard St NW,"(38.9268, -77.0322)",2,16,18,12:23:20
31106,Calvert & Biltmore St NW,"(38.923203, -77.047637)",9,12,21,12:23:20
31107,Lamont & Mt Pleasant NW,"(38.9319, -77.0388)",3,14,17,12:23:20
31108,4th & M St SW,"(38.8767, -77.0178)",9,12,21,12:23:20
31201,15th & P St NW,"(38.90985, -77.034438)",5,9,14,12:23:20
31202,14th & R St NW,"(38.91293854609145, -77.03208535909653)",3,16,19,12:23:20
31203,14th & Rhode Island Ave NW,"(38.9086, -77.0323)",2,21,23,12:23:20
31400,Georgia & New Hampshire Ave NW,"(38.936043, -77.024649)",2,12,14,12:23:20
31401,14th St & Spring Rd NW,"(38.9375, -77.0328)",11,8,19,12:23:20
31502,John McCormack Dr & Michigan Ave NE,"(38.9346, -76.9955)",5,6,11,12:23:20
31600,5th & K St NW,"(38.90304, -77.019027)",8,10,18,12:23:20
31601,19th & East Capitol St SE,"(38.8896, -76.9769)",5,9,14,12:23:20
31602,Park Rd & Holmead Pl NW,"(38.9308, -77.0315)",10,8,18,12:23:20
31700,Good Hope & Naylor Rd SE,"(38.86022668950909, -76.96657240390778)",5,6,11,12:23:20
31305,Connecticut Ave & Newark St NW / Cleveland Park,"(38.934267, -77.057979)",3,6,9,12:23:20
31702,Randle Circle & Minnesota Ave SE,"(38.878, -76.9607)",3,7,10,12:23:20
31703,Minnesota Ave Metro/DOES,"(38.897063, -76.947446)",9,5,14,12:23:20
31704,Nannie Helen Burroughs & Minnesota Ave NE,"(38.901385, -76.941877)",8,3,11,12:23:20
31801,Anacostia Metro,"(38.862669, -76.994637)",5,5,10,12:23:20
31802,Good Hope Rd & MLK Ave SE,"(38.867373, -76.988039)",4,6,10,12:23:20
31206,19th & E Street NW,"(38.8952, -77.0436)",3,8,11,12:23:20
31500,4th & W St NE,"(38.919077, -77.000648)",2,12,14,12:23:20
31111,10th & U St NW,"(38.9172, -77.0259)",2,13,15,12:23:20
31207,Georgia Ave and Fairmont St NW,"(38.9249, -77.0222)",0,11,11,12:23:20
31209,1st & N St  SE,"(38.8743, -77.0057)",2,36,38,12:23:20
31110,20th St & Florida Ave NW,"(38.9154, -77.0446)",6,7,13,12:23:20
31109,7th & T St NW,"(38.9155, -77.0222)",13,1,14,12:23:20
31013,Eads & 22nd St S,"(38.85438051517749, -77.05341160297394)",4,11,15,12:23:20
31208,M St & New Jersey Ave SE,"(38.8763, -77.0037)",3,12,15,12:23:20
31200,Massachusetts Ave & Dupont Circle NW,"(38.9101, -77.0444)",12,30,42,12:23:20
31603,1st & M St NE,"(38.9057, -77.0056)",4,11,15,12:23:20
31212,21st & M St NW,"(38.90534, -77.046774)",6,11,17,12:23:20
31213,17th & K St NW,"(38.90276, -77.03863)",9,11,20,12:23:20
31604,3rd & H St NW,"(38.899408, -77.015289)",0,15,15,12:23:20
31605,3rd & D St SE,"(38.8851, -77.0023)",10,1,11,12:23:20
31606,Potomac & Pennsylvania Ave SE,"(38.8803, -76.9862)",7,7,14,12:23:20
31607,13th & E St SE,"(38.88291548476762, -76.98790669441223)",2,13,15,12:23:20
31214,17th & Corcoran St NW,"(38.9121, -77.0387)",6,13,19,12:23:20
31300,Van Ness Metro / UDC,"(38.944551, -77.063896)",5,7,12,12:23:20
31503,Florida Ave & R St NW,"(38.9126, -77.0135)",3,12,15,12:23:20
31608,8th & Eye St SE / Barracks Row,"(38.8792, -76.9953)",5,6,11,12:23:20
31301,Ward Circle / American University,"(38.938736, -77.087171)",7,8,15,12:23:20
31302,Wisconsin Ave & Newark St NW,"(38.934881, -77.072755)",8,8,16,12:23:20
31402,14th St Heights / 14th & Crittenden St NW,"(38.947774, -77.032818)",5,6,11,12:23:20
31804,Anacostia Library,"(38.865784, -76.9784)",5,6,11,12:23:20
31805,Pennsylvania & Minnesota Ave SE,"(38.873057, -76.971015)",2,9,11,12:23:20
31610,Eastern Market / 7th & North Carolina Ave SE,"(38.886952, -76.996806)",1,13,14,12:23:20
31216,14th St & New York Ave NW,"(38.899632, -77.031686)",5,16,21,12:23:20
31705,Benning Branch Library,"(38.894, -76.947974)",5,6,11,12:23:20
31217,USDA / 12th & C St SW,"(38.88627694506511, -77.02824175357819)",11,26,37,12:23:20
31501,12th & Newton St NE,"(38.933668, -76.991016)",3,8,11,12:23:20
31220,US Dept of State / Virginia Ave & 21st St NW,"(38.894919, -77.046587)",9,6,15,12:23:20
31218,L'Enfant Plaza / 7th & C St SW,"(38.886266, -77.022241)",15,0,15,12:23:20
31219,10th St & Constitution Ave NW,"(38.893028, -77.026013)",9,15,24,12:23:20
31211,Kennedy Center,"(38.897293, -77.05557)",7,10,17,12:23:20
31613,Eastern Market Metro / Pennsylvania Ave & 7th St SE,"(38.884, -76.995397)",19,0,19,12:23:20
31221,18th & M St NW,"(38.90506687455313, -77.04177886247635)",7,19,26,12:23:20
31303,Tenleytown / Wisconsin Ave & Albemarle St NW,"(38.947607, -77.079382)",4,9,13,12:23:20
31611,13th & H St NE,"(38.900021783466954, -76.98842167854308)",11,16,27,12:23:20
31620,5th & F St NW,"(38.897222, -77.019347)",0,26,26,12:23:20
31222,New York Ave & 15th St NW,"(38.89903234416315, -77.03335404396057)",2,17,19,12:23:20
31223,Convention Center / 7th & M St NW,"(38.905737, -77.02227)",3,20,23,12:23:20
31112,Harvard St & Adams Mill Rd NW,"(38.927872, -77.043358)",7,8,15,12:23:20
31224,19th & L St NW,"(38.903407, -77.043648)",12,3,15,12:23:20
31225,C & O Canal & Wisconsin Ave NW,"(38.90375, -77.06269)",2,18,20,12:23:20
31609,Maine Ave & 7th St SW,"(38.878693599396954, -77.02305436134338)",0,19,19,12:23:20
31612,D St & Maryland Ave NE,"(38.894758, -76.997114)",13,9,22,12:23:20
31226,34th St & Wisconsin Ave NW,"(38.916442, -77.0682)",4,4,8,12:23:20
31228,8th & H St NW,"(38.8997, -77.023086)",9,23,32,12:23:20
31505,Eckington Pl & Q St NE,"(38.910972, -77.00495)",15,8,23,12:23:20
31615,6th & H St NE,"(38.899972, -76.998347)",1,20,21,12:23:20
31616,3rd & H St NE,"(38.900412, -77.001949)",3,15,18,12:23:20
31617,Bladensburg Rd & Benning Rd NE,"(38.900413, -76.982872)",7,7,14,12:23:20
31618,4th & East Capitol St NE,"(38.889955, -77.000349)",1,9,10,12:23:20
31619,Lincoln Park / 13th & East Capitol St NE ,"(38.890461, -76.988355)",4,21,25,12:23:20
31701,Branch & Pennsylvania Ave SE,"(38.8692, -76.9599)",6,5,11,12:23:20
31622,13th & D St NE,"(38.894832, -76.987633)",6,24,30,12:23:20
31229,New Hampshire Ave & T St NW,"(38.91554, -77.03818)",4,19,23,12:23:20
31230,Metro Center / 12th & G St NW,"(38.898364, -77.027869)",7,32,39,12:23:20
31231,14th & D St NW / Ronald Reagan Building,"(38.894514, -77.031617)",8,17,25,12:23:20
31234,20th & O St NW / Dupont South,"(38.908905, -77.04478)",2,15,17,12:23:20
31621,4th & D St NW / Judiciary Square,"(38.895344, -77.016106)",6,9,15,12:23:20
31235,19th St & Constitution Ave NW,"(38.8923, -77.0436)",3,31,34,12:23:20
31236,37th & O St NW / Georgetown University,"(38.90774, -77.071652)",9,13,22,12:23:20
31614,11th & H St NE,"(38.899983, -76.991383)",11,8,19,12:23:20
31237,25th St & Pennsylvania Ave NW,"(38.903827, -77.053485)",6,8,14,12:23:20
31623,Columbus Circle / Union Station,"(38.89696, -77.00493)",10,43,53,12:23:20
31624,North Capitol St & F St NW,"(38.897446, -77.009888)",14,9,23,12:23:20
31266,11th & M St NW,"(38.905607, -77.027137)",1,17,18,12:23:20
31304,36th & Calvert St NW / Glover Park,"(38.922581, -77.070334)",4,9,13,12:23:20
31238,14th & G St NW,"(38.898409, -77.032278)",6,15,21,12:23:20
31052,Potomac Ave & 35th St S,"(38.844015, -77.050537)",6,17,23,12:23:20
31240,Ohio Dr & West Basin Dr SW / MLK & FDR Memorials,"(38.88412, -77.04657)",4,25,29,12:23:20
31262,11th & F St NW,"(38.897857, -77.026975)",3,12,15,12:23:20
31260,23rd & E St NW ,"(38.896104, -77.049882)",5,14,19,12:23:20
31014,Lynn & 19th St North,"(38.897315, -77.070993)",17,13,30,12:23:20
31015,Rosslyn Metro / Wilson Blvd & Ft Myer Dr,"(38.8946, -77.072305)",7,11,18,12:23:20
31016,Clarendon Blvd & Pierce St,"(38.893438, -77.076389)",9,4,13,12:23:20
31017,Wilson Blvd & N Uhle St,"(38.891696, -77.0846)",4,11,15,12:23:20
31018,N Rhodes & 16th St N,"(38.892164, -77.079375)",5,4,9,12:23:20
31706,Fairfax Village,"(38.86559, -76.952103)",3,11,14,12:23:20
31261,21st St & Constitution Ave NW,"(38.892459, -77.046567)",6,8,14,12:23:20
31019,Wilson Blvd & N Edgewood St,"(38.889, -77.0925)",1,14,15,12:23:20
31113,Columbia Rd & Belmont St NW,"(38.920669, -77.04368)",1,18,19,12:23:20
31239,Rhode Island & Connecticut Ave NW,"(38.905995699991145, -77.03980207443237)",7,15,22,12:23:20
31241,Thomas Circle,"(38.9059, -77.0325)",6,24,30,12:23:20
31020,Wilson Blvd & Franklin Rd,"(38.8904, -77.0889)",6,4,10,12:23:20
31021,Clarendon Blvd & N Fillmore St,"(38.8881, -77.09308)",8,7,15,12:23:20
31022,Clarendon Metro / Wilson Blvd & N Highland St,"(38.88786, -77.094875)",4,13,17,12:23:20
31242,18th St & Pennsylvania Ave NW,"(38.89968, -77.041539)",6,19,25,12:23:20
31243,4th & C St SW,"(38.88637194054526, -77.01770067214966)",5,33,38,12:23:20
31244,4th & E St SW,"(38.88412, -77.017445)",4,15,19,12:23:20
31625,3rd & G St SE,"(38.881185, -77.001828)",4,15,19,12:23:20
31245,7th & R St NW / Shaw Library,"(38.912719, -77.022155)",4,9,13,12:23:20
31404,9th & Upshur St NW,"(38.9418, -77.0251)",10,5,15,12:23:20
31506,1st & Rhode Island Ave NW,"(38.915417, -77.012289)",6,8,14,12:23:20
31115,Columbia Rd & Georgia Ave NW,"(38.92812111132096, -77.0237946510315)",8,11,19,12:23:20
31116,California St & Florida Ave NW,"(38.917761, -77.04062)",15,4,19,12:23:20
31707,Benning Rd & East Capitol St NE / Benning Rd Metro,"(38.889935, -76.93723)",10,8,18,12:23:20
31307,3000 Connecticut Ave NW / National Zoo,"(38.930282, -77.055599)",9,6,15,12:23:20
31708,Anacostia Ave & Benning Rd NE / River Terrace ,"(38.896544, -76.96012)",3,11,14,12:23:20
31246,M St & Pennsylvania Ave NW,"(38.905126, -77.056887)",6,13,19,12:23:20
31626,15th St & Massachusetts Ave SE,"(38.88732, -76.983569)",4,11,15,12:23:20
31806,Congress Heights Metro,"(38.844711, -76.987823)",4,11,15,12:23:20
31035,N Quincy St & Glebe Rd,"(38.876393, -77.107735)",7,3,10,12:23:20
31033,Barcroft Community Center,"(38.85033657788445, -77.1009886264801)",6,5,11,12:23:20
31029,N Veitch  & 20th St N,"(38.896923, -77.086502)",4,11,15,12:23:20
31263,10th & K St NW,"(38.9024, -77.02622)",4,19,23,12:23:20
31023,Fairfax Dr & Wilson Blvd,"(38.885801, -77.097745)",4,6,10,12:23:20
31027,Key Blvd & N Quinn St,"(38.896355, -77.078408)",3,8,11,12:23:20
31628,1st & K St SE,"(38.878854378063295, -77.00572729110718)",6,7,13,12:23:20
31306,39th & Calvert St NW / Stoddert,"(38.922649, -77.077271)",6,13,19,12:23:20
31507,1st & Washington Hospital Center NW,"(38.928743, -77.012457)",7,7,14,12:23:20
31024,Virginia Square Metro / N Monroe St & 9th St N,"(38.882788, -77.103148)",6,12,18,12:23:20
31025,Central Library / N Quincy St & 10th St N,"(38.88397, -77.10783)",1,9,10,12:23:20
31026,Washington Blvd & 10th St N,"(38.884734, -77.093485)",5,10,15,12:23:20
31247,Jefferson Dr & 14th St SW,"(38.888553, -77.032429)",8,15,23,12:23:20
31248,Smithsonian-National Mall / Jefferson Dr & 12th St SW,"(38.888767, -77.02858)",1,32,33,12:23:20
31036,George Mason Dr & Wilson Blvd,"(38.87887, -77.1207)",10,5,15,12:23:20
31264,6th St & Indiana Ave NW,"(38.894573, -77.01994)",4,14,18,12:23:20
31028,N Veitch & Key Blvd,"(38.893237, -77.086063)",3,7,10,12:23:20
31030,Lee Hwy & N Adams St,"(38.89593, -77.089006)",8,10,18,12:23:20
31031,15th & N Scott St,"(38.89054, -77.08095)",1,10,11,12:23:20
31032,Washington Blvd & 7th St N,"(38.88081, -77.090792)",7,4,11,12:23:20
31037,Ballston Metro / N Stuart & 9th St N,"(38.881044, -77.111768)",4,19,23,12:23:20
31034,N Randolph St & Fairfax Dr,"(38.882629, -77.109366)",2,9,11,12:23:20
31249,Jefferson Memorial,"(38.879819, -77.037413)",9,13,22,12:23:20
31803,Good Hope Rd & 14th St SE,"(38.866611, -76.985238)",9,6,15,12:23:20
31038,Glebe Rd & 11th St N,"(38.883921, -77.116817)",3,7,10,12:23:20
31039,Wilson Blvd & N Quincy St,"(38.880012, -77.107854)",11,3,14,12:23:20
31040,Fairfax Dr & Kenmore St,"(38.884616, -77.10108)",7,4,11,12:23:20
31508,Gallaudet / 8th St & Florida Ave NE,"(38.90509, -76.9941)",6,13,19,12:23:20
31250,20th & L St NW,"(38.903584, -77.044789)",7,12,19,12:23:20
31251,12th & L St NW,"(38.903819, -77.0284)",2,15,17,12:23:20
31252,21st St & Pennsylvania Ave NW,"(38.901539, -77.046564)",6,12,18,12:23:20
31253,19th & K St NW,"(38.902204, -77.04337)",3,20,23,12:23:20
31041,Prince St & Union St,"(38.803124, -77.040363)",3,14,17,12:23:20
31042,Market Square / King St & Royal St,"(38.804718, -77.043363)",0,15,15,12:23:20
31043,Saint Asaph St & Pendleton  St,"(38.810743, -77.044664)",4,11,15,12:23:20
31044,King St & Patrick St,"(38.805317, -77.049883)",1,13,14,12:23:20
31254,15th & K St NW,"(38.902, -77.03353)",6,20,26,12:23:20
31045,Commerce St & Fayette St,"(38.805648, -77.05293)",10,5,15,12:23:20
31046,Henry St & Pendleton St,"(38.811456, -77.050276)",9,8,17,12:23:20
31047,Braddock Rd Metro,"(38.814577, -77.052808)",15,14,29,12:23:20
31048,King St Metro South,"(38.805767, -77.06072)",14,9,23,12:23:20
31255,24th & N St NW,"(38.9066, -77.05152)",1,12,13,12:23:20
31256,10th & E St NW,"(38.895914, -77.026064)",4,11,15,12:23:20
31257,22nd & I St NW / Foggy Bottom,"(38.90088, -77.048911)",7,8,15,12:23:20
31049,Utah St & 11th St N ,"(38.883669, -77.113905)",1,10,11,12:23:20
31050,Barton St & 10th St N,"(38.884961, -77.08777)",6,5,11,12:23:20
31051,Arlington Blvd & N Queen St,"(38.889365, -77.077294)",6,5,11,12:23:20
31258,Lincoln Memorial,"(38.888251, -77.049426)",11,13,24,12:23:20
31259,20th St & Virginia Ave NW,"(38.894722, -77.045128)",7,8,15,12:23:20
31265,5th St & Massachusetts Ave NW,"(38.90093, -77.018677)",12,7,19,12:23:20
31308,39th & Veazey St NW,"(38.943837, -77.077078)",3,11,14,12:23:20
31309,Fessenden St & Wisconsin Ave NW,"(38.954812, -77.082426)",6,9,15,12:23:20
31627,3rd & M St NE,"(38.905469714943266, -77.0021304488182)",18,4,22,12:23:20
31053,Columbia Pike & S Courthouse Rd,"(38.863833, -77.080319)",2,13,15,12:23:20
31054,Walter Reed Community Center / Walter Reed Dr & 16th St S,"(38.857803, -77.086733)",4,7,11,12:23:20
31055,28th St S & S Meade St,"(38.846222, -77.069275)",7,7,14,12:23:20
31114,18th St & Wyoming Ave NW,"(38.918809, -77.041571)",2,19,21,12:23:20
31403,5th & Kennedy St NW,"(38.956555547721955, -77.0198142528534)",11,4,15,12:23:20
31405,Georgia Ave & Emerson St NW,"(38.949662, -77.027333)",8,9,17,12:23:20
31406,14th & Upshur St NW,"(38.942016, -77.032652)",4,14,18,12:23:20
31407,14th St & Colorado Ave NW,"(38.956432, -77.032947)",6,13,19,12:23:20
31056,S Troy St & 26th St S,"(38.847977, -77.075104)",1,10,11,12:23:20
31057,S Four Mile Run Dr & S Shirlington Rd,"(38.8444, -77.085931)",3,6,9,12:23:20
31058,S Oakland St & Columbia Pike,"(38.860789, -77.09586)",8,3,11,12:23:20
31059,S Four Mile Run & Walter Reed Dr,"(38.84736, -77.095431)",1,10,11,12:23:20
31060,S Arlington Mill Dr & Campbell Ave,"(38.84232, -77.089555)",9,6,15,12:23:20
31061,S Kenmore & 24th St S,"(38.848454, -77.084918)",4,6,10,12:23:20
32006,13th St & Eastern Ave,"(38.987, -77.029417)",10,4,14,12:23:20
31312,Wisconsin Ave & O St NW,"(38.90849, -77.063586)",3,15,18,12:23:20
31062,Roosevelt Island,"(38.896553, -77.06714)",3,9,12,12:23:20
31310,Connecticut & Nebraska Ave NW,"(38.955016, -77.069956)",15,8,23,12:23:20
31267,17th St & Massachusetts Ave NW,"(38.908142, -77.038359)",1,17,18,12:23:20
31117,15th & Euclid St  NW,"(38.92333, -77.0352)",5,9,14,12:23:20
31629,8th & East Capitol St NE,"(38.889988, -76.995193)",6,4,10,12:23:20
31509,New Jersey Ave & R St NW,"(38.912659, -77.017669)",4,10,14,12:23:20
31630,15th & East Capitol St NE,"(38.889908, -76.983326)",7,4,11,12:23:20
31631,8th & F St NE,"(38.897274, -76.994749)",8,7,15,12:23:20
31510,18th St & Rhode Island Ave NE,"(38.927095, -76.978924)",11,4,15,12:23:20
31632,15th & F St NE,"(38.897195, -76.983575)",5,13,18,12:23:20
31511,12th & Irving St NE,"(38.928644, -76.990955)",4,11,15,12:23:20
31800,Alabama & MLK Ave SE,"(38.84322988730829, -76.99937582015991)",4,7,11,12:23:20
31807,Pleasant St & MLK Ave SE,"(38.863897, -76.990037)",8,3,11,12:23:20
31512,Neal St & Trinidad Ave NE,"(38.903732, -76.987211)",7,5,12,12:23:20
31268,12th & U St NW,"(38.916787, -77.028139)",6,25,31,12:23:20
31063,S George Mason Dr & Four Mile Run,"(38.852248, -77.105022)",8,2,10,12:23:20
31064,S Stafford & 34th St S,"(38.834108, -77.087323)",5,6,11,12:23:20
31065,N Pershing Dr & Wayne St,"(38.880705, -77.08596)",3,7,10,12:23:20
31066,Columbia Pike & S Orme St,"(38.867262, -77.072315)",5,5,10,12:23:20
31269,3rd St & Pennsylvania Ave SE,"(38.887378, -77.001955)",3,11,14,12:23:20
31270,8th & D St NW,"(38.894851, -77.02324)",9,6,15,12:23:20
31118,3rd & Elm St NW,"(38.917622, -77.01597)",6,9,15,12:23:20
31513,Rhode Island Ave & V St NE,"(38.918155, -77.004746)",6,13,19,12:23:20
31271,Constitution Ave & 2nd St NW/DOL,"(38.892275, -77.013917)",7,20,27,12:23:20
31272,Washington & Independence Ave SW/HHS,"(38.886978, -77.013769)",11,19,30,12:23:20
31633,Independence Ave & L'Enfant Plaza SW/DOE,"(38.887312, -77.025762)",5,10,15,12:23:20
31514,Hamlin & 7th St NE,"(38.927497, -76.997194)",5,8,13,12:23:20
31067,Columbia Pike & S Walter Reed Dr,"(38.862478, -77.086599)",7,3,10,12:23:20
31068,Columbia Pike & S Dinwiddie St / Arlington Mill Community Center,"(38.856319, -77.11153)",5,8,13,12:23:20
31069,Pershing & N George Mason Dr,"(38.871822, -77.107906)",0,10,10,12:23:20
32001,Fenton St & New York Ave ,"(38.985404, -77.023082)",5,10,15,12:23:20
32002,Bethesda Ave & Arlington Rd,"(38.981103, -77.097426)",5,14,19,12:23:20
32003,Montgomery Ave & Waverly St ,"(38.983838, -77.09221)",2,9,11,12:23:20
32004,Fallsgrove Blvd & Fallsgrove Dr,"(39.096312, -77.192672)",13,6,19,12:23:20
32005,Traville Gateway Dr & Gudelsky Dr,"(39.093783, -77.202501)",9,10,19,12:23:20
32000,Norfolk Ave & Fairmont St,"(38.988562, -77.096539)",9,2,11,12:23:20
32007,E Montgomery Ave & Maryland Ave,"(39.084125, -77.151291)",4,11,15,12:23:20
32008,Cordell & Norfolk Ave,"(38.98954, -77.098029)",1,10,11,12:23:20
32010,Philadelphia & Maple Ave,"(38.98128, -77.011336)",12,3,15,12:23:20
32011,Maple & Ritchie Ave,"(38.983627, -77.006311)",10,9,19,12:23:20
32012,Silver Spring Metro/Colesville Rd & Wayne Ave,"(38.99521, -77.02918)",8,10,18,12:23:20
32013,Montgomery & East Ln,"(38.983525, -77.095367)",5,6,11,12:23:20
32014,Friendship Hts Metro/Wisconsin Ave & Wisconsin Cir,"(38.961763, -77.085998)",7,12,19,12:23:20
31119,14th & Belmont St NW,"(38.921074, -77.031887)",7,8,15,12:23:20
31634,3rd & Tingey St SE,"(38.87501, -77.0024)",2,16,18,12:23:20
31120,10th & Florida Ave NW,"(38.920387, -77.025672)",11,6,17,12:23:20
31635,Potomac Ave & 8th St SE,"(38.876737, -76.994468)",8,7,15,12:23:20
32015,Crabbs Branch Way & Redland Rd,"(39.120045, -77.156985)",7,8,15,12:23:20
32016,Fallsgrove Dr & W Montgomery Ave,"(39.099376, -77.188014)",7,8,15,12:23:20
32017,Monroe St & Monroe Pl,"(39.083673, -77.149162)",12,3,15,12:23:20
32018,Needwood Rd & Eagles Head Ct,"(39.123513, -77.15741)",7,8,15,12:23:20
32019,East West Hwy & Blair Mill Rd,"(38.990249, -77.02935)",5,10,15,12:23:20
32020,Crabbs Branch Way & Calhoun Pl,"(39.107709, -77.152072)",8,7,15,12:23:20
32021,47th & Elm St,"(38.982456, -77.091991)",3,12,15,12:23:20
32022,Dennis & Amherst Ave,"(39.02538719623632, -77.04456299543381)",6,8,14,12:23:20
32023,Montgomery College/W Campus Dr & Mannakee St,"(39.095661, -77.159048)",14,7,21,12:23:20
32024,Fenton St & Gist Ave,"(38.989724, -77.023854)",10,1,11,12:23:20
32025,Carroll & Westmoreland Ave,"(38.975, -77.01121)",7,8,15,12:23:20
32026,Carroll & Ethan Allen Ave,"(38.977933, -77.006472)",5,10,15,12:23:20
32027,Battery Ln & Trolley Trail,"(38.992375, -77.100104)",8,7,15,12:23:20
32028,Norfolk & Rugby Ave,"(38.990639, -77.100239)",4,7,11,12:23:20
32029,Offutt Ln & Chevy Chase Dr,"(38.977093, -77.094589)",7,4,11,12:23:20
32030,Broschart & Blackwell Rd,"(39.102099, -77.200322)",6,9,15,12:23:20
32031,Taft St & E Gude Dr,"(39.094103, -77.132954)",3,12,15,12:23:20
32032,Fleet St & Ritchie Pkwy,"(39.076331, -77.141378)",9,6,15,12:23:20
32033,Piccard & W Gude Dr,"(39.102212, -77.177091)",7,12,19,12:23:20
32034,Ripley & Bonifant St,"(38.992679, -77.029457)",5,10,15,12:23:20
32035,Georgia Ave & Spring St,"(38.999388, -77.031555)",8,3,11,12:23:20
32036,Fenton St & Ellsworth Dr ,"(38.997033, -77.025608)",5,10,15,12:23:20
32037,King Farm Blvd & Pleasant Dr,"(39.114688, -77.171487)",10,8,18,12:23:20
32038,King Farm Blvd & Piccard Dr,"(39.110314, -77.182669)",6,8,14,12:23:20
31121,Calvert St & Woodley Pl NW,"(38.923583, -77.050046)",13,5,18,12:23:20
31636,New Jersey Ave & N St NW/Dunbar HS,"(38.90706, -77.015231)",13,6,19,12:23:20
31710,Nannie Helen Burroughs Ave & 49th St NE,"(38.898536, -76.931862)",8,2,10,12:23:20
31711,Deanwood Rec Center,"(38.908473, -76.933099)",11,4,15,12:23:20
31273,Hains Point/Buckeye & Ohio Dr SW,"(38.878433, -77.03023)",5,10,15,12:23:20
31070,Arlington Blvd & Fillmore St,"(38.873755, -77.089233)",5,5,10,12:23:20
31071,Long Bridge Park/Long Bridge Dr & 6th St S,"(38.86646, -77.04826)",3,8,11,12:23:20
32039,Old Georgetown Rd & Southwick St,"(38.999634, -77.109647)",11,8,19,12:23:20
32040,Friendship Blvd & Willard Ave,"(38.96115, -77.088659)",7,12,19,12:23:20
31637,North Capitol St & G Pl NE,"(38.899703, -77.008911)",10,8,18,12:23:20
31072,31st & Woodrow St S,"(38.837666, -77.09482)",6,5,11,12:23:20
31073,Washington Blvd & Walter Reed Dr ,"(38.873219, -77.082104)",11,4,15,12:23:20
31074,TJ Cmty Ctr / 2nd St & S Old Glebe Rd,"(38.869418, -77.095596)",3,12,15,12:23:20
31313,Connecticut Ave & Tilden St NW,"(38.941154, -77.062036)",10,5,15,12:23:20
32041,Medical Center Dr & Key West Ave,"(39.103091, -77.196442)",7,8,15,12:23:20
32042,Shady Grove Hospital,"(39.097636, -77.196636)",8,11,19,12:23:20
32043,Veterans Pl & Pershing Dr ,"(38.997445, -77.023894)",5,6,11,12:23:20
32044,Rockville Metro East,"(39.085394, -77.145803)",8,5,13,12:23:20
31638,1st & H St NW,"(38.900358, -77.012108)",2,13,15,12:23:20
31515,Fort Totten Metro,"(38.952369, -77.002721)",9,9,18,12:23:20
31408,Takoma Metro,"(38.975219, -77.016855)",7,10,17,12:23:20
31516,Rhode Island Ave Metro,"(38.920682, -76.995876)",0,18,18,12:23:20
31075,Rolfe St & 9th St S,"(38.866471, -77.076131)",0,11,11,12:23:20
31076,Shirlington Transit Center / S Quincy & Randolph St,"(38.839912, -77.087083)",8,7,15,12:23:20
32045,Shady Grove Metro West,"(39.119765, -77.166093)",5,14,19,12:23:20
32046,River Rd & Landy Ln,"(38.964992, -77.103381)",6,13,19,12:23:20
32047,Rockville Metro West,"(39.084379, -77.146866)",5,14,19,12:23:20
32048,Bethesda Metro,"(38.984691, -77.094537)",4,8,12,12:23:20
31077,Iwo Jima Memorial/N Meade & 14th St N,"(38.88992, -77.071301)",4,12,16,12:23:20
31314,34th & Water St NW,"(38.903662690050474, -77.0676684380669)",5,13,18,12:23:20
31081,Duke St & John Carlyle St,"(38.804378, -77.060866)",6,9,15,12:23:20
31079,Lee Hwy & N Cleveland St,"(38.894941, -77.09169)",10,5,15,12:23:20
31078,Arlington Blvd & S George Mason Dr/NFATC,"(38.869442, -77.104503)",4,10,14,12:23:20
31274,10th & G St NW,"(38.89824328774852, -77.02623546123505)",10,12,22,12:23:20
31080,Lee Hwy & N Scott St,"(38.897612, -77.080851)",8,7,15,12:23:20
31275,New Hampshire Ave & 24th St NW,"(38.901755, -77.051084)",5,13,18,12:23:20
31082,Eisenhower Ave & Mill Race Ln,"(38.801111, -77.068952)",6,9,15,12:23:20
31083,Potomac Greens Dr & Slaters Ln,"(38.82175, -77.047494)",3,8,11,12:23:20
31084,Ballenger Ave & Dulaney St,"(38.802677, -77.063562)",5,14,19,12:23:20
31085,Mount Vernon Ave & E Nelson Ave,"(38.820064, -77.057619)",6,5,11,12:23:20
31086,Mount Vernon Ave & E Del Ray Ave,"(38.82595, -77.058541)",13,2,15,12:23:20
31087,Monroe Ave & Leslie Ave,"(38.820932, -77.053096)",11,4,15,12:23:20
31088,Mount Vernon Ave & Kennedy St,"(38.833077, -77.059821)",10,5,15,12:23:20
31089,Court House Metro / 15th & N Uhle St ,"(38.890612, -77.084801)",2,18,20,12:23:20
32049,Washington Adventist U / Flower Ave & Division St,"(38.986743, -77.000035)",7,8,15,12:23:20
31090,6th & S Ball St,"(38.864702, -77.048672)",9,6,15,12:23:20
31315,McKinley St & Connecticut Ave NW,"(38.96454350924588, -77.07513481378555)",13,6,19,12:23:20
31276,15th & L St NW,"(38.90366, -77.034846)",3,18,21,12:23:20
31277,17th & G St NW,"(38.89841, -77.039624)",5,26,31,12:23:20
32050,Spring St & Second Ave,"(38.997653, -77.034499)",4,11,15,12:23:20
31278,18th & R St NW,"(38.912648, -77.041834)",2,17,19,12:23:20
31091,S Joyce & 16th St S,"(38.859254, -77.063275)",3,12,15,12:23:20
31517,Union Market/6th St & Neal Pl NE,"(38.908387, -76.996869)",19,3,22,12:23:20
31092,Lee Hwy & N Monroe St,"(38.896456, -77.104562)",11,4,15,12:23:20
31093,21st St N & N Pierce St,"(38.898984, -77.078317)",4,11,15,12:23:20
31094,Lee Hwy & N Kirkwood Rd,"(38.895377, -77.09713)",9,5,14,12:23:20
31279,19th & G St NW,"(38.898412, -77.043182)",10,13,23,12:23:20
31522,2nd St & Seaton Pl NE,"(38.914751108831155, -77.00356006622314)",0,0,0,12:23:20
31902,Wilson Blvd & N Illinois St ,"(38.876528, -77.12712)",8,4,12,12:23:20
31095,Army Navy Dr & S Nash St,"(38.86215024521491, -77.06812083721161)",6,4,10,12:23:20
31293,31st & Water St NW,"(38.902814, -77.061043)",1,18,19,12:23:20
31280,11th & S St NW,"(38.913761, -77.027025)",15,7,22,12:23:20
31096,S Walter Reed Dr & 8th St S,"(38.86612, -77.08787)",7,6,13,12:23:20
31639,2nd & G St NE,"(38.89967, -77.003666)",6,17,23,12:23:20
31281,8th & O St NW,"(38.90864, -77.02277)",5,13,18,12:23:20
31411,Georgia & Missouri Ave NW,"(38.961339, -77.027855)",6,10,16,12:23:20
31712,Oklahoma Ave & D St NE,"(38.894474, -76.974828)",7,11,18,12:23:20
31640,Maryland Ave & E St NE,"(38.896134, -76.9929)",6,12,18,12:23:20
31518,New York Ave & Hecht Ave NE,"(38.915604, -76.983683)",9,13,22,12:23:20
31316,Yuma St & Tenley Circle NW,"(38.946182, -77.08059)",8,11,19,12:23:20
32051,Connecticut Ave & Chevy Chase Lake Dr,"(38.994113, -77.076986)",6,9,15,12:23:20
32052,Key West Ave & Siesta Key Way,"(39.105295, -77.194774)",6,9,15,12:23:20
31900,Lee Hwy & N Woodstock St,"(38.898301, -77.118009)",4,14,18,12:23:20
31097,Saint Asaph & Madison St,"(38.812718, -77.044097)",11,4,15,12:23:20
31098,King St Metro North / Cameron St,"(38.80704, -77.059817)",4,11,15,12:23:20
31099,Madison & N Henry St,"(38.813485, -77.049468)",4,11,15,12:23:20
32053,Medical Center Metro ,"(38.999378, -77.097882)",3,16,19,12:23:20
31901,Washington Blvd & N Frederick St,"(38.884829, -77.127671)",6,5,11,12:23:20
31317,Wisconsin Ave & Ingomar St NW,"(38.958267, -77.084636)",8,11,19,12:23:20
31122,16th & Irving St NW,"(38.928893, -77.03625)",13,6,19,12:23:20
31282,16th & R St NW,"(38.912652, -77.036278)",2,17,19,12:23:20
32054,Lyttonsville Rd & Lyttonsville Pl,"(38.999679, -77.051168)",5,10,15,12:23:20
32055,Woodmont Ave & Strathmore St,"(38.979875, -77.093522)",3,8,11,12:23:20
31283,14th & L St NW,"(38.903658, -77.031737)",11,8,19,12:23:20
31519,1st & O St NW,"(38.908643, -77.012365)",8,7,15,12:23:20
31811,South Capitol & Atlantic St SW,"(38.831516, -77.008133)",3,16,19,12:23:20
31284,18th & C St NW,"(38.893511, -77.041544)",8,11,19,12:23:20
31285,22nd & P ST NW,"(38.909394, -77.048728)",11,8,19,12:23:20
32056,East West Hwy & 16th St,"(38.995681, -77.038721)",7,12,19,12:23:20
31903,Royal & Wilkes St,"(38.799267, -77.0447)",9,6,15,12:23:20
31123,14th & Girard St NW,"(38.925284, -77.032375)",0,22,22,12:23:20
31910,Potomac Ave & Main Line Blvd,"(38.822738, -77.049265)",12,6,18,12:23:20
31286,11th & O St NW,"(38.90843, -77.02714)",5,11,16,12:23:20
31287,10th St & L'Enfant Plaza SW,"(38.88432272414662, -77.02601015567778)",6,17,23,12:23:20
31318,Connecticut Ave & Yuma St NW,"(38.947156, -77.065115)",9,10,19,12:23:20
31641,2nd St & Massachusetts Ave NE,"(38.894972, -77.003135)",9,13,22,12:23:20
31908,Radford & Osage St,"(38.828437, -77.086031)",7,16,23,12:23:20
31904,East Falls Church Metro/Sycamore St & 19th St N,"(38.884859, -77.155988)",9,10,19,12:23:20
31905,Kennebec St & 11th St N,"(38.880992, -77.135271)",5,9,14,12:23:20
31906,Commonwealth Ave & Oak St,"(38.812711, -77.061715)",12,7,19,12:23:20
31913,Commonwealth & E Monroe Ave,"(38.82005823354218, -77.06282079219818)",10,4,14,12:23:20
31288,4th St & Madison Dr NW,"(38.890493, -77.017253)",8,22,30,12:23:20
31289,Henry Bacon Dr & Lincoln Memorial Circle NW,"(38.890544, -77.049379)",6,12,18,12:23:20
31290,17th St & Independence Ave SW,"(38.888097, -77.038325)",2,15,17,12:23:20
31907,Franklin & S Washington St,"(38.798133, -77.0487)",14,5,19,12:23:20
31909,Mount Vernon Ave & Four Mile Run Park,"(38.843422, -77.064016)",11,4,15,12:23:20
31642,New Jersey Ave & L St NW,"(38.903598, -77.01397)",5,18,23,12:23:20
31912,Mount Vernon Ave & Bruce St,"(38.841291, -77.063093)",8,7,15,12:23:20
31914,Lee Center,"(38.797557, -77.053766)",11,4,15,12:23:20
31915,Powhatan St & Bashford Ln,"(38.818748, -77.047783)",10,5,15,12:23:20
31916,Potomac & Swann Ave,"(38.829545, -77.047844)",7,11,18,12:23:20
31124,14th & Irving St NW,"(38.928552, -77.032224)",10,21,31,12:23:20
31291,Vermont Ave & I St NW,"(38.901136451737045, -77.03445106744766)",10,15,25,12:23:20
31319,Wisconsin Ave & Brandywine St NW,"(38.949813, -77.080217)",12,13,25,12:23:20
31520,24th & R St NE / National Arboretum,"(38.91263, -76.971923)",6,13,19,12:23:20
31713,Division Ave & Foote St NE,"(38.897407, -76.925907)",5,10,15,12:23:20
31812,16th & Q St SE / Anacostia HS,"(38.870695, -76.982359)",6,17,23,12:23:20
32200,Spring Hill Metro,"(38.929261, -77.240654)",5,9,14,12:23:20
32201,Westpark Dr & Leesburg Pike,"(38.92403, -77.235955)",3,8,11,12:23:20
32203,Tysons One Pl & Chain Bridge Rd,"(38.919475, -77.221179)",3,8,11,12:23:20
32204,Tysons Corner Station,"(38.920939, -77.222115)",4,6,10,12:23:20
32205,Westpark & Jones Branch Dr,"(38.924437, -77.217664)",9,2,11,12:23:20
32206,Jones Branch & Westbranch Dr,"(38.931911, -77.219261)",6,5,11,12:23:20
32207,Westpark & Park Run Dr,"(38.928919, -77.225394)",5,6,11,12:23:20
32208,Tysons West Transit Center,"(38.932636, -77.231825)",4,7,11,12:23:20
32209,North Shore & Cameron Crescent Dr/Crescent Apartments,"(38.970046, -77.338686)",10,1,11,12:23:20
32210,Town Center Pkwy & Bowman Towne Dr,"(38.962524, -77.361902)",13,2,15,12:23:20
32211,Reston Regional Library,"(38.962095, -77.358815)",7,8,15,12:23:20
32212,New Dominion Pkwy & Fountain Dr,"(38.960574, -77.356324)",6,9,15,12:23:20
32213,Sunset Hills & Old Reston Ave,"(38.955079, -77.351649)",7,8,15,12:23:20
32214,Reston Town Center Transit Station,"(38.957037, -77.359718)",5,12,17,12:23:20
31643,1st & D St SE,"(38.884916, -77.005965)",1,18,19,12:23:20
32215,Reston Station,"(38.948363, -77.338119)",10,25,35,12:23:20
32216,Library St & Freedom Dr,"(38.959633, -77.358741)",7,10,17,12:23:20
32217,Sunset Hills Rd & Discovery Square,"(38.95534, -77.357611)",5,10,15,12:23:20
31292,22nd St & Constitution Ave NW,"(38.892441, -77.048947)",7,15,22,12:23:20
31714,61st St & Banks Pl NE,"(38.891805, -76.913563)",9,9,18,12:23:20
32218,Temporary Rd & Old Reston Ave,"(38.960084, -77.353414)",4,11,15,12:23:20
32219,Reston YMCA,"(38.955314, -77.368416)",4,11,15,12:23:20
32220,Sunset Hills Rd & Isaac Newton Square,"(38.951443, -77.340377)",6,5,11,12:23:20
31917,N Lynn St & Fairfax Dr,"(38.89386, -77.070862)",8,6,14,12:23:20
31414,Georgia Ave & Piney Branch Rd NW,"(38.967505, -77.027976)",4,11,15,12:23:20
32221,Greensboro & International Dr,"(38.923083, -77.227417)",4,6,10,12:23:20
31918,Madison & Fairfax St,"(38.812351, -77.040691)",9,6,15,12:23:20
32058,Sligo Ave & Carroll Ln,"(38.990874, -77.016311)",6,8,14,12:23:20
31125,15th & W St NW,"(38.919086, -77.034502)",16,3,19,12:23:20
31644,12th St & Pennsylvania Ave SE,"(38.882489, -76.990121)",10,8,18,12:23:20
31412,3rd St & Riggs Rd NE,"(38.957463, -77.002239)",11,4,15,12:23:20
31919,Carlin Springs Rd & N Thomas St,"(38.876695, -77.112982)",10,4,14,12:23:20
32222,Towers Crescent Dr & Tysons One Pl,"(38.915246, -77.220157)",9,2,11,12:23:20
31645,6th & K St NE,"(38.9028773031307, -76.99840486049652)",3,15,18,12:23:20
32057,Pooks Hill Rd & Linden Ave,"(39.014716, -77.107143)",9,6,15,12:23:20
32059,Takoma Park Rec Center,"(38.98265, -76.988311)",8,7,15,12:23:20
32061,New Hampshire & Kirklynn Ave,"(38.988101, -76.988422)",7,8,15,12:23:20
32062,Wheaton Metro/Georgia Ave & Reedie Dr,"(39.038341, -77.051023)",6,13,19,12:23:20
32063,Amherst Ave & Elkins St,"(39.044887, -77.047788)",6,9,15,12:23:20
32064,Amherst Ave & Prichard Rd,"(39.035965, -77.048395)",6,9,15,12:23:20
32065,Grandview & Blueridge Ave,"(39.043272, -77.053085)",4,10,14,12:23:20
32066,Windham Ln & Amherst Ave,"(39.032029, -77.04735)",10,5,15,12:23:20
32223,North Shore Dr & Village Rd,"(38.970412, -77.340787)",6,5,11,12:23:20
32224,Town Center Pkwy & Sunset Hills Rd,"(38.955170598044894, -77.3630940914154)",7,4,11,12:23:20
31413,3rd & Underwood St NW,"(38.968834, -77.016258)",10,9,19,12:23:20
31521,18th & Monroe St NE,"(38.93293, -76.979517)",7,12,19,12:23:20
31294,7th & E St SW,"(38.88345, -77.021741)",6,13,19,12:23:20
32067,Shady Grove Metro East,"(39.121327, -77.164969)",11,8,19,12:23:20
31295,Potomac & M St NW,"(38.905368, -77.065149)",6,13,19,12:23:20
31296,Columbia & Ontario Rd NW,"(38.924088, -77.040787)",7,16,23,12:23:20
31920,Washington-Lee High School / N Stafford St & Generals Way,"(38.888282, -77.111066)",5,10,15,12:23:20
31921,Westover Library / Washington Blvd & N McKinley Rd,"(38.886048, -77.142317)",6,8,14,12:23:20
31923,Columbia Pike & S Taylor St,"(38.858524, -77.103728)",6,8,14,12:23:20
32068,Columbus Ave & Tribeca St,"(39.126, -77.1673)",8,3,11,12:23:20
32069,Columbus Ave & Gramercy Blvd,"(39.12333, -77.16486)",8,3,11,12:23:20
32225,Reston Pkwy & Spectrum Dr,"(38.964207741006206, -77.35428035259247)",4,11,15,12:23:20
32070,Key West Ave & Great Seneca Hwy,"(39.105642, -77.20386)",5,6,11,12:23:20
31297,Virginia Ave & 25th St NW,"(38.8995, -77.054155)",3,15,18,12:23:20
31298,15th & M St NW,"(38.905424, -77.034674)",3,16,19,12:23:20
31126,11th & Girard St NW,"(38.925636, -77.027112)",4,14,18,12:23:20
31299,Connecticut Ave & R St NW,"(38.912644, -77.04564)",9,10,19,12:23:20
31924,Wilson Blvd & N Troy St,"(38.892556, -77.082089)",4,11,15,12:23:20
31320,Nebraska Ave/AU East Campus,"(38.936298, -77.087128)",1,18,19,12:23:20
31321,15th St & Constitution Ave NW,"(38.892244, -77.033234)",5,14,19,12:23:20
31127,22nd & H St NW,"(38.899104, -77.048946)",8,9,17,12:23:20
31128,23rd & M St NW,"(38.905303, -77.050264)",5,14,19,12:23:20
32071,Corporate Blvd & Omega Dr,"(39.106971, -77.192645)",13,2,15,12:23:20
32072,Key West Ave & Diamondback Dr,"(39.106152, -77.202354)",6,5,11,12:23:20
31813,Alabama Ave & Stanton Rd SE / Shops at Park Village,"(38.84627, -76.98185)",9,10,19,12:23:20
31814,Mississippi Ave & 19th St SE / THEARC,"(38.84377, -76.97557)",4,15,19,12:23:20
31815,19th & Savannah St SE,"(38.84623, -76.97703)",4,7,11,12:23:20
31816,4th St & Mississippi Ave SE,"(38.836, -77.0009)",5,14,19,12:23:20
31817,1st & S Capitol St SE / Oxon Run Trail,"(38.824481, -77.005497)",5,13,18,12:23:20
31818,Livingston Rd & 3rd St SE,"(38.82373, -77.00223)",3,11,14,12:23:20
31819,Joliet St & MLK Ave SW/Bald Eagle Rec Ctr,"(38.81909, -77.01033)",6,13,19,12:23:20
31715,37th & Ely Pl SE / Fort Dupont Ice Arena,"(38.883011, -76.949709)",5,10,15,12:23:20
31129,15th St & Pennsylvania Ave NW/Pershing Park,"(38.89635, -77.03338)",10,8,18,12:23:20
31646,Maine Ave & 9th St SW,"(38.88044, -77.025236)",4,11,15,12:23:20
31523,Lincoln Rd & Seaton Pl NE/Harry Thomas Rec Center,"(38.915, -77.0078)",9,8,17,12:23:20
32073,Blueridge Ave & Elkins St,"(39.04313, -77.05006)",5,10,15,12:23:20
31415,Georgia Ave & Kennedy St NW,"(38.95674, -77.02791)",6,11,17,12:23:20
31647,7th St & Massachusetts Ave NE,"(38.89222, -76.99602)",11,7,18,12:23:20
31820,Anacostia Park,"(38.87335, -76.9834)",4,15,19,12:23:20
32074,Twinbrook Metro,"(39.062041, -77.120776)",7,7,14,12:23:20
32075,White Flint Metro,"(39.04753, -77.11287)",6,19,25,12:23:20
32076,Citadel Ave & McGrath Blvd,"(39.049, -77.10933)",11,4,15,12:23:20
32077,Rockville Pike & Old Georgetown Rd,"(39.049765, -77.11368)",11,4,15,12:23:20
32078,Woodglen Dr & Executive Blvd,"(39.04317, -77.1135)",8,8,16,12:23:20
32079,Executive Blvd & E Jefferson St,"(39.04873, -77.1257)",9,6,15,12:23:20
32080,Fishers Ln & Rock Creek Mill Rd,"(39.0629, -77.113454)",6,9,15,12:23:20
32081,Congressional Ln & E Jefferson St,"(39.06219, -77.129235)",9,5,14,12:23:20
32082,Garland Ave & Walden Rd,"(39.00048, -77.00077)",9,6,15,12:23:20
32227,Greensboro & Pinnacle Dr,"(38.92245, -77.23034)",5,8,13,12:23:20
32400,1301 McCormick Dr / Wayne K. Curry Admin Bldg,"(38.908391, -76.843263)",7,8,15,12:23:20
32401,Largo Town Center Metro,"(38.899811, -76.844604)",11,6,17,12:23:20
32402,Baltimore Ave & Van Buren St / Riverdale Park Station,"(38.969581, -76.937349)",10,6,16,12:23:20
32403,Baltimore Ave & Jefferson St,"(38.95548, -76.940133)",9,6,15,12:23:20
32404,Perry & 35th St,"(38.936213, -76.960054)",6,8,14,12:23:20
32083,Grand Park & Rose Ave,"(39.0510352, -77.1176)",6,9,15,12:23:20
31648,Potomac Ave & Half St SW,"(38.870201045557025, -77.01083689928055)",11,12,23,12:23:20
31925,Crystal Dr & Potomac Ave,"(38.848304, -77.05122)",1,10,11,12:23:20
32405,Largo Rd & Campus Way / Prince Georges's Comm Col,"(38.88994, -76.825535)",8,6,14,12:23:20
31822,Stanton Square SE,"(38.855004, -76.984512)",9,9,18,12:23:20
31649,14th & Newton St NW,"(38.931991, -77.032956)",9,10,19,12:23:20
31322,48th Pl & MacArthur Blvd NW,"(38.917304, -77.09629)",5,14,19,12:23:20
31416,14th & Luzon St NW,"(38.969489, -77.033509)",8,11,19,12:23:20
31650,1st & M St SE,"(38.876893, -77.006072)",6,13,19,12:23:20
32406,Fleet St & Waterfront St,"(38.782633, -77.016059)",7,8,15,12:23:20
32407,Oxon Hill Park & Ride,"(38.798749, -77.00103)",8,6,14,12:23:20
31651,11th & Park Rd NW,"(38.93165, -77.028305)",7,11,18,12:23:20
31417,Kansas Ave & Sherman Cr NW,"(38.948057, -77.021467)",4,15,19,12:23:20
32228,Campus Commons,"(38.944707, -77.335425)",4,7,11,12:23:20
32229,Park Run & Onyx Dr,"(38.92755, -77.226644)",5,6,11,12:23:20
31653,7th & K St NW,"(38.902674, -77.021392)",4,15,19,12:23:20
